-23
23
-10
14
00000000000000000000000000000000000000000000000
00000000000000000000000000000000000000000000000
11111111111111111111111111111111111111111111111
00000000000000000000000000000000000000000000000
00000000000000000000000000000000000000000000000
00000000000000000000000000000000000000000000000
00000000000000000000000000000000000000000000000
00000000000000000000000000000000000000000000000
00000000000000000000000000000000000000000000000
00000000000000000000000000000000000000000000000
00000000000000000000000000000000011000000000000
00000000000000000000000000111111100000000000000
00000000000010000000000000111111100000000000000
00000000000000000000000000111111100000000000000
00000000000000100000000000111111100000000000000
00000000000000000000000000111111100000000000000
00000000000000000000000000111111100000000000000
00000000000000000000000000111111100000000000000
00000000000000000000000000000000000000000000000
00000000000000000000000000000000000000000000000
00000000000000000000000000000000000000000000000
00000000000000000000000000000000000000000000000
00000000000000000000000000000000000000000000000
00000000000000000000000000000000000000000000000
00000000000000000000000000000000000000000000000
